000000000000000000000000000000000000000000000000000000000000000000000000000000000000000000000000000000000000000000000000000000000000000000000000000000000000000000000000000000000000
000000000000000000000000000000000000888880000000000055500000000000090000000000000000000050000000000000000000000008888800000000000000005550000555500000000000055550000000000000000000
005500000000033300000000000000000000000000000000055000000000000009990000000005500000000050055500000000000330000000088800000550000000000000000000000000000000000000040000000000000000
000000000000000000000000000000000000008880000000000005500000009990000005555000000000000050000000000000000030000000005500000055000000055000055000000000000000000000020000000000000000
000000033000000000000000000000000008888880000000000000000000000090000000000000000000000050000005550000003330000000888800000000000000000000000000000000000000000005550000000000000000
000000000009000000000990990000000000000000000000000550000000009999000000000000000000000050000000000000000000000088800000000000000000000000000000000000000088800000000000000000000000
000000000009000000000000000000000000000888800000000000000000000000000000009000000000000000000000000000333333000888800000000000000000000000000005555000000000000000040400000000000000
000000090099000000000040404000000000080000000000000000000000000000990000999000000000000550000550000000000000000000800055555550000000005555000000000000008888800000020200000000000000
000000990000000055000020202000000000009000000000000000000009000000090000000999900000000000000000000003330000000888800000000050000000000000000000000000888888880000555500000000000000
000090000000000000099999999999000000999000000000000000099999000099000000000000000000000000055550000000000000000000000008005550000000000000000055550000000088880000000000000060000000
999999999999999999999999999999000000099999999999990000000000000000000099990999999990000999999990000099999999009999999999999990099999999990009999999998888888888888800008888888888880
999999999999999999999999999999999999999999999999999999999999999999999999990999999999999999999990009999999999009999999999999999999999999999090999999999888880088800000000888888888888
